SNNNEENNNS
NNNNEENNNN
EEEEEEEEEE
NNNNNNNNNN
NNNNNNNNNN
EEEEEEEEEE
NNNNEENNNN
SNNNEENNNS
EEEEEEEEEE
