SNSNSNSNSN
NNNNNNNNNN
EEEEEEEEEE
NNNEEEENNN
NNEESSEENN
NEEEEEEEEN
NEEENNEEEN
NEEENNEEEN
NEEEEEEEEN
