NNNNNNNNNN
NNNNNNNNNN
NNNNNNNNNN
NNNNNNNNNN
EEEEEEEEEE
ESEEEEEESE
EESEEEESEE
EEEEEEEEEE
EEEEEEEEEE
