NNNNNNNNNN
NENNEENNEN
SSSEEEESSS
NNNEEEENNN
NNNNNNNNNN
SESEEEESES
ENENNNNENE
EEEEEEEEEE
EEEEEEEEEE
