NNNNNNNNNN
NNNNSSNNNN
NNNSSSSNNN
NNNSSSSNNN
NNNSSSSNNN
NNNNSSNNNN
NNNNNNNNNN
EEEEEEEEEE
EEEEEEEEEE
